
    VERBOS	
English Portugues
-------------------
paint 	pintar
ride 	andar de
cook 	cozinhar
meet 	encontrar
run 	correr
go 	    ir
choose 	escolher
forget 	esquecer
take 	pegar
live	ao vivo
get 	pegar
lie 	mentira
listen	ouvir
open 	Abrir
give 	dar
understand 	entender
drive 	dirigir
find 	encontrar
make 	pendência
like 	como
play 	jogar
cry 	chorar
fly 	voar
put 	colocar
snow 	neve
draw 	desenhar 
hear 	ouvir
think 	pensar
wash 	para lavar
love 	amor
buy 	comprar
talk 	falar
stay 	ficar
catch 	pegar
move 	mover
want 	querer
help 	ajuda
shout 	gritar
learn 	aprender
brush 	Escovar
sing 	cantar
come 	venha 
begin 	iniciar
fall 	cair
ask 	perguntar
call 	chamar
bring 	trazer
know 	saber
pay 	pagar
have 	Ter
tell 	dizer
sell 	vender
try 	tentar
look 	olhar
win 	ganhar
earn	ganhar
sign 	sinal
build 	construir
chat 	bater papo
eat 	comer
start 	iniciar
work 	trabalhar
hope 	esperança
leave 	deixar
travel 	viagem
speak 	falar
lose 	perder
wait 	espere
walk 	andar
can 	ele pode
read 	ler
rain 	chuva
be 	    ser
write 	escrever
enjoy 	curtir
visit 	Visita
spend 	gastar
feel 	sentir
dance 	dança
sleep 	dormir
watch 	frequentar
say 	dizer
sit 	sentar
must 	deve
break 	quebrar
stand 	ficar
arrive 	chegar
become 	tornar-se
die 	morrer
clean 	limpar
wear 	vestir
teach 	ensinar
send 	enviar
see 	ver
swim 	nadar
finish 	terminar
study 	estudar
ski  	esquiar 
show 	Mostrar
drink	beber
